--------------------
|                  |
|             v    |
| ------------------
|                  |
|                  |
|                  |
|                  |
|                  |
|                  |
|                  |
|--------- -----   |
|        | |   |   |
|        | | ^ |   |
|        | |   |   |
|          --- -   |
|$       |         |
|        |         |
|        |         |
--------------------