          ----------
          |        |
          |        |
          |        |
          |        |
          ---- -----
             | |    
-------------- -----
|                  |
|                  |
|                  |
|                  |
|                  |
--------------------