          ----------
          |        |
          |   v  R |
          |        |
          |        |
          ---- -----
             | |    
-------------- -----
|    $$$$          |
|                  |
|                  |
|                  |
|                  |
--------- ----------
        | |         
--------- -         
|         |
|         |
|         |
-----------