          ----------
          |       $|
          |   v   $|
          |       $|
          |       $|
          ---- -----
             | |    
-------------- -----
|                  |
|                  |
|     $$$$$$$$$$   |
|                  |
|                  |
--------------------