--------------------
|                  |
|             ^    |
|- --------------- |
 | |             | |
 | |-            | |
|    |           | |
| $  |           | |
|----------------- |
|                  |
|         ---------|
|         |        |
|         |   |    |
|         | v |    |
|         |   |    |
|         -----    |
|                  |
|----- ------------|
|                 $|
--------------------