--------------------
|              | $ |
|                  |
|         ---------|
|--       |         
  |       |         
  |       |         
|--       |         
|         ---------|
|         |        |
|              | $ |
|         ---------|
|              |    
|         | ^  |    
| --------|    |    
|         |    |    
|         |--------|
|                  |
|------------|    v|
             -------